#####################
#A                  #
# # # ##### # ##### #
#   #     #   #     #
##### ### ####### # #
#     # #       #   #
# ##### ####### # # #
#       #     # # # #
####### # ### # # # #
#       # # # # # # #
# ####### # # # # # #
#         #   #    B#
####################