A ############
#    #   #   #
##  ## # #   #
#   #  #  ####
# ###### #   #
#  #      ## #
# #### ## ## #
# #  # #   # #
# ## # ####  #
#    #  #   ##
### ## ### # #
#B           #
##############
