A #########   
#     #   #   
### # ### #   
#   #   # ####
# ### ###    #
#   #     ## #
### #######  #
#     #    # #
# ### #### # #
# #   #  #   #
# #### ## ## #
#      #    B#
##############
